10 10
9 9
5 6
1 5 0 2 1 1 4 2 2 2
2 4 2 5 2 5 0 5 0 0
1 1 2 4 5 5 1 1 3 2
4 2 3 2 0 0 4 5 4 0
2 4 2 0 5 5 4 2 0 0
1 1 1 3 3 1 2 3 0 5
0 3 1 3 3 3 3 0 3 3
4 0 3 2 3 4 1 3 3 3
5 4 2 4 4 2 0 3 2 0
5 3 1 3 5 3 1 0 1 1